0000001100
0P00011100
0011111000
00000000X0
0000000000